............
..X...X.....
.03.........
.....X...#..
.........#..
X..##..33...
..3.....3...
X.3...##....
..3...XG33..
X.3....3....
...##...#...
.X.X....#.X.